Easy (7x7, 1 box)
1111111120104110300011101101110000111101111111111
1111111111114111100011103001100000112111111111111
1111111111112110000011010301100000114100111111111

Medium (10x10, 2 boxes)
1111111111100011111110101000411400000011110100000111003300111100000011111110011111120011111111111111
1111111111111111100111110000411111010011110003000111013000011100000001100000000112100001411111111111
1111111111111111100114001000111010000301100001012110100000111003000411111001011111100001111111111111

Hard (13x7, 3 boxes)
1111111111111120001111000110010000100011100000333001114010000000111111041001411111111111111
1111111111111112000000000111001000101011100033300001110010010014114000001004111111111111111
1111111111111111000200014114000000000011001001000101110333001000111000140000111111111111111
